

                   
                   
               XXXXXXXXXXXXXXXXXXXXXXXX    
               X         X            X
               X         X            X
          XXXXXXXXXX    XXXXX         X
          X    X   X    X   X         X
     XXXXXX    X   XXXXXX   XXX XXX   X
     X    X    X   X    X   X X X X   X
XXXXXXXXXXXXXX XXXXXXXXXXXXXX XXXXX   X
       X              X         X X   X
       X              X         XXX   X
       XXXXXXXXXXXXXXXX               X  
       X      X                       X
       X                              X
       X                              X
       XXXXXXXXXXXXXXXXXXXXXXXXXXXXXXXX        
